%%%%%%%%%%%%%%%%%%%%%%%%%%%%%%%%%%%%
%....%.%.%                         %
%.%%.%.%.%              %%%        %
%.%%.%.%.%%%%%%%%%%%%%%%%.%%%%%%%% %
%.%%.%.%....%....%....%.....%....% % 
%....%.%.%%.%.%%.%.%%%%%%.%%%.%%.% %
%.%%.%.%.%%.%.%%.%.%    %.% %.%%.% %
%.%%.%.%.%%.%....%.%    %.% %.%%.% %    
%.%%.%.%.%%.%.%%%%.%    %.% %.%%.% %
%.%%.%.%....%....%.%    %.% %....% %
%P%%                               %
%%%%%%%%%%%%%%%%%%%%%%%%%%%%%%%%%%%%